┌───────────────────────┐
│#......................│
│─┐..│..┌─────┐..│..└───│
│─┘..│..│.....│..│..┌───│
│.......└──┐..│..│..└┘..│
│.┌┘.┌┐.......│.........│
└───────────────────────┘

