┌───────────────────────┐
│#......................│
│.┌──┐..┌┐........│.....│
│.└─┐│..││.──────.│.┌─┐.│
│...└┘..└┘........└───┘.│
│─┐........┌────┐.......│
└───────────────────────┘