┌───────────────────────┐
│#................│...└─│
│─┐..┌┐....┌──┐..┌┘.....│
│.└──┘│....│  │.......┌─│
│...└─┘....└──┘......┌┘ │
│....................│  │
└───────────────────────┘