┌───────────────────────┐
│#.│..└┘..│............└│
│..│......│.............│
│..└─.........┌──────┐..│
│.......───...│..│.│.│..│
│...┌┐...............│..│
└───────────────────────┘